






NO assets/window.xpm



SO assets/window.xpm



F 208,171,147
C 155,202,255





WE assets/window.xpm
EA assets/wood.xpm


1111111111111111111111111111111111111111111111111111111111
10000000000000000000000000000000000000000000000000000000001
10000000000000000000000000000000000000000000000000000000001
10000000000000000000000000000000000000000000000000000000001
1000000000000000000000000000000000000000000000000000000000011111
1001DD10000111D00001111000011110001111000D1D1D0000111011100001
100100010001000100010001000100000010000001000D0001000D00010001
1001000100010001000100010001000000D000000D000100010000000D0001
10011111000111100001111000011D000011D1000111DD0001000000010001
100100010001000100010001000D0000000001000D000D0000100000100001
10010001000D00010001000100010000000001000D00010000010001000001
100100010001000100011110000111100011D10001000D0000001010000001
10000000000000000000000000000000000000000000000000000100000000111111111111111111111111111111111111111111111111
10000000000000000000000000000000000000N0000000000000000000000000000001
100000000000000000000000000000X0000000000000000000000000000000000000001
100000000000000000000000000000000000000000000000000000000000000000000001
1111111111111111111111111111111111111111111111111111111111111111111111111111111111111111111