
F 0,0,0
C 0,0,0

NO ./assets/cat/albanie.xpm
SO ./assets/cat/albanie.xpm
WE ./assets/cat/chuck.xpm
EA ./assets/cat/chuck.xpm


1111111111111111111111111111111111111111111111111111111111111
10000000000000000000000000000000000000000000000XXXXXXXXX00001
100000000XXXXXXXX1111000000000000000011111111111100XXXXX00001
1000XXXXXX000000111100XXXXXXXXXXXXXXXXXXXXX000011000000000001
1000000000000011110000000000000000000000000000011000XXXX00001
1000000000000111100000000000000000000000000000011000000000001
1000000000001111XXXX00000000000000000000000XXXX11000000000001
1000000000011110000000000000N00000000111111111111000000000001
100000000011111111111100000000000000011000000000000XXXXX00001
1000000000000000000110000000000000000110000000XXXXXXX00000001
100000000000000000011000000XXX0000000110000000000000000000001
1000XXXXXX000000000110000000000000000110000000000000000000001
1000000000000000000110000000000000000111111111111000000000001
1000000000000000000XXXXXX0000000000000000XXXXXX00000000000001
1111111111111111111111111111111111111111111111111111111111111