
F 227,193,148
C 1,149,237

NO ./assets/cat/beach.xpm
SO ./assets/cat/beach.xpm
WE ./assets/cat/beach.xpm
EA ./assets/cat/beach.xpm

1111111111111
100X000000001
1000X00000111
1011001001111
10010000N0X01
100001D100001
111111D111111
1XX0000XXXXX1
1000000000001
1000000000001
1000000000001
1111111111111