
F 0,0,0
C 0,0,0

NO ./assets/cat/albanie.xpm
SO ./assets/cat/albanie.xpm
WE ./assets/cat/chuck.xpm
EA ./assets/cat/chuck.xpm


        1111111111111111111111111
        1000000000110000000000001
        1011000001110000000000001
        1001000000000000XX0000001
1111111110110X0001110000000000001
10000000001100000111011111D111111
11110111111111011100000010001
111101111111110111010100D0001
110X000011010101110000001XXX1
100XX000000000001100000000X01
100XX00000000000DD01010010001
110XX00D1D0D0D011111011110N0111
11110D11 1DD0D01 111111110X01
11111111 1111111 111111111111