







NO assets/cat/albanie.xpm
SO assets/cat/albanie.xpm



F 208,171,147
C 155,202,243





WE assets/brick.xpm
EA assets/wood.xpm






        1111111111111111111111111
        1000000000110000000000001
        1011000001110000000000001
        1001000000000000000000001
111111111011000001110000000000001
10000000001100000111D11111D111111
11110111111111011100000010001
11110111111111D111010100D0001
110X000011010101110000001XXX1
100XX000000000001100000000X01
100XX00000000000DD01010010001
110XX00D1D0D0D011111011110N0111
11110D11 1DD0D01 111111110001
11111111 1111111 111111111111